00500093
00500113
00700193
ffd00213
00208463
06f00293
00100293
00308463
00200313
00309463
0de00393
00300393
00209463
00400413
00324463
14d00493
00500493
0011c463
00600513
0011d463
1bc00593
00700593
00325463
00800613
0030e463
22b00693
00900693
0011e463
00a00713
0011f463
29a00793
00b00793
0030f463
00c00813
0000006f