00a00293
00800313
004300e7
00528293
07b00393
00008413