00000000
00000005
0000000A
FFFFFFFD
0000000F
00000005
00000000
FFFFFFFD
FFFFFFF8
00000001
00001400
00000000
FFFFFFFF
0000000F
00000005
00000000
FFFFFFFD
FFFFFFF8
00000001
00001400
00000000
FFFFFFFF
00000000
00000000
00000000
00000000
00000000
00000000
00000000
00000000
00000000
00000000