00500093
00a00113
ffd00193
00208233
401102b3
0020f333
0030e3b3
0030c433
0021a4b3
00209533
001155b3
4011d633
00020693
00028713
00030793
00038813
00040893
00048913
00050993
00058a13
00060a93