00000000
00000005
0000000a
fffffffd
0000000f
00000005
00000000
fffffffd
fffffff8
00000001
00001400
00000000
ffffffff
0000000f
00000005
00000000
fffffffd
fffffff8
00000001
00001400
00000000
ffffffff
00000000
00000000
00000000
00000000
00000000
00000000
00000000
00000000
00000000
00000000
