00008417
00840413
00028497
0204a483
fff48493
02905e63
00000293
00008317
fec30313
0292d263
00032383
00432e03
007e5663
01c32023
00732223
00128293
00430313
fe1ff06f
fff48493
fc9ff06f
00210063