10010537
00500293
00a00313
00f00393
06400413
06900493
00552023
00652223
00752423
00852623
00952823